+----+--------+-+-+---------+
|    |        | | |         |
|    | +---+  | | | +-----+ |
| +--+ | +-+    | +------|  |
|   +--+        +--  -----+ |
|         +   |             |
+-+-  +  ----------  |  ----+
| |   | +--+  |      |   || |
| |   | |  ++ +---+  +-+ || |
| | + | |       +-+      || |
| +-+ | +---+     +-+  +--| |
|             |       +---| |
+-------------+-------------+
