+-----+-----------+-+---------+
|  |  |           | |         |
|  |  |    +---+  + |     |   |
|  |  +----+   |    |     +---+
|  |           +--+ |         |
|  +---+  +  +      |  +----+ |
|      |  +--+  +---+  |      |
|   +--+               | +-+  |
+-+        +-----------+ | |  |
| + +------+             | |  |
|            +----+--  --+ |  |
|  + +---+   +    |        |  |
|  | |   |     +  +--------+  |
| ++ | +-+  +---+             |
| |  |         +  +--------+  |
|    |  +---+                 |
+----+------------------------+
